0000000000000010
0111100000000010
0000000000000010
0000111000000010
0000000000000010
0000000000000010
0000001000100010
0000000101000010
0000000000000010
0000000000000010