1000000000000001
1111100000000011
1000000000000011
1000111000220011
1000000000220001
1000000000000001
1000001000100011
1000000101000011
1000000000000011
1111111111111111