1111111111111111
1111100000000011
1000000000000011
1000111000220011
1000000000220001
1000000000000001
1000001000100011
1000000101000011
1000000000000011
1111122221111111
1000000000000001
1000000022000001
1000000022000001
1000000000000001
1000000000000001
1111111111111111