0000000000000000
0111100000000000
0000000000000000
0000111000000000
0000000000000000
0000000000000000
0000001000100000
0000000101000000
0000000000000000
0000000000000000