1111111111111111
1000000000000001
1000220000000001
1000111000220001
1000200000220001
1000000000000001
1000221000100011
1000000101000011
1000000000000011
1111122221111111
1000000000000001
1000000022000001
1000000022000001
1000000000000001
1000000000000001
1111111111111111